SSSSSSSSSSSSSSSSSSSSSSSSSSSSSS
S0000000C0C00000000SS00000000S
S000000000000000000SS00000000S
S000000000000000000SS00000000S
S000000000000000000SS00000000S
S000000000000000000SS00000000S
S00000000000000000L00D0000000S
S00000000000000000L00D0000000S
S000000000000000000SS00000000S
S00000000P000000000SS00000000S
S000000000000000000SS00000000S
S000000000000000000SS00000000S
S000000000000000000SS00000000S
S000000000000000000SS00000000S
SSSSSSSSSSSSSSSSSSSSSSSSLLSSSS
SSSSSSSSSSSSSSSSSSSSSSSS00SSSS
SSSSSSSSSSSSSSSSSSSSSSSS00SSSS
SSSSSSSSSSSSSSSSSSSSSSSS00SSSS
SSSSSSSSSSSSSSSSSSSSSSSS00SSSS
SSSSSSSSSSSSSSSSSSSSSSSS0CSSSS
SSSSSSSSSSSSSSSSSSSSSSSSSSSSSS